                                                                                                           
 ######################################################################################################### 
 # *               * ## *               * ##        * *        ##*******   *********##*******   *********# 
 #*                 *##*                 *##        * *        ##******* ***********##******* ***********# 
 #                   ##                   ##        * *        ##**    *     *******##**    *     *******# 
 #        * *        ##        * *        ##        * *        ##** ** ***** ****   ##** ** ***** ****   # 
 #       *   *       ##       *   *       ##********* *********##** ** **    **** * ##** ** **    **** * # 
 #         %         $$         %         $$                   $$ * **    *    ** * $$ * **    *    ** * # 
 #       *   *       ##       *   *       ##********* *********## * *****   ** ** **## * *****   ** ** **# 
 #        * *        ##        * *        ##        * *        ##   ***** **** ** **##   ***** **** ** **# 
 #                   ##                   ##        * *        ##********    *    **##********    *    **# 
 #*                 *##*                 *##        * *        ##*********** *******##*********** *******# 
 # *               * ## *               * ##        * *        ##*********   *******##*********   *******# 
 ##########$###################################################################################$########## 
 ##########$###################################################################################$########## 
 # *               * ##        * *        ##*******   *********## *               * ##                   # 
 #*                 *##        * *        ##******* ***********##*                 *##                   # 
 #                   ##        * *        ##**    *     *******##                   ##                   # 
 #        * *        ##      *** ***      ##** ** ***** ****   ##        * *        ##                   # 
 #       *   *       ##*******     *******##** ** **    **** * ##       *   *       ##                   # 
 #         %         ##        b%b        $$ * **    *    ** * $$         %         ##         &         # 
 #       *   *       ##*******     *******## * *****   ** ** **##       *   *       ##                   # 
 #        * *        ##      *** ***      ##   ***** **** ** **##        * *        ##                   # 
 #                   ##        * *        ##********    *    **##                   ##                   # 
 #*                 *##        * *        ##*********** *******##*                 *##                   # 
 # *               * ##        * *        ##*********   *******## *               * ##                   # 
 ##########$####################$#########################################$############################### 
 ##########$####################$#########################################$############################### 
 #                   ## *               * ## *               * ## *               * ## *               * # 
 #                   ##*                 *##*                 *##*                 *##*                 *# 
 #                   ##                   ##                   ##                   ##                   # 
 #                   ##        * *        ##        * *        ##        * *        ##        * *        # 
 #                   ##       *   *       ##       *   *       ##       *   *       ##       *   *       # 
 #                   $$         %         ##         %         $$         %         $$         %         # 
 #                   ##       *   *       ##       *   *       ##       *   *       ##       *   *       # 
 #                   ##        * *        ##        * *        ##        * *        ##        * *        # 
 #                   ##                   ##                   ##                   ##                   # 
 #                   ##*                 *##*                 *##*                 *##*                 *# 
 #                   ## *               * ## *               * ## *               * ## *               * # 
 ######################################################################################################### 
                                                                                                           
