#######################################################################################
#######################################################################################
##               ##               ##               ##               ##               ##
##               ##               ##               ##               ##               ##
##               ##               ##               ##               ##               ##
##               ##               ##               ##               ##               ##
##               ##               $$               $$               $$               ##
##               ##               ##               ##               ##               ##
##               ##               ##               ##               ##               ##
##               ##               ##               ##               ##               ##
##               ##               ##               ##               ##               ##
#########$################$##################################################$#########
#########$################$##################################################$#########
##               ##               ##               ##               ##               ##
##               ##               ##               ##               ##               ##
##               ##               ##               ##               ##               ##
##               ##               ##               ##               ##               ##
##               ##               ##               $$               ##               ##
##               ##               ##               ##               ##               ##
##               ##               ##               ##               ##               ##
##               ##               ##               ##               ##               ##
##               ##               ##               ##               ##               ##
#########$################$#################################$################$#########
#########$################$#################################$################$#########
##               ##               ##               ##               ##               ##
##               ##               ##               ##               ##               ##
##               ##               ##               ##               ##               ##
##               ##               ##               ##               ##               ##
##               $$               $$               $$               ##               ##
##               ##               ##               ##               ##               ##
##               ##               ##               ##               ##               ##
##               ##               ##               ##               ##               ##
##               ##               ##               ##               ##               ##
#######################################################################################
#######################################################################################
